11111121111111111111111000000000000000000001100000000000000000
10000000000000000000000000000000000000000000000000000000000001
10000002012111110000000000020121111100000000000201211111000001
10010000000000010000000100000000000100000001000000000001000001
10010020000220111000100100200002201110001001002000022011100011
10101000111100000000001010001111000000000010100011110000000001
10000000000000000000000000000000000000000000000000000000000001
10000000000000000000000000000000000000000000000000000000000001
10000002012111110000000000020121111100000000000201211111000001
10010000000000010000000100000000000100000001000000000001000001
10010020000220111000100100200002201110001001002000022011100011
10101000111100000000001010001111000000000010100011110000000001
10000000000000000000011000000000000000000001100000000000000000
11111121111111111111111000000000000000000001100000000000000000
10000000000000000000000000000000000000000000000000000000000001
10000002012111110000000000020121111100000000000201211111000001
10010000000000010000000100000000000100000001000000000001000001
10010020000220111000100100200002201110001001002000022011100011
10101000111100000000001010001111000000000010100011110000000001
10000000000000000000000000000000000000000000000000000000000001
10000000000000000000000000000000000000000000000000000000000001
10000002012111110000000000020121111100000000000201211111000001
10010000000000010000000100000000000100000001000000000001000001
10010020000220111000100100200002201110001001002000022011100011
10101000111100000000001010001111000000000010100011110000000001
10000000000000000000011000000000000000000001100000000000000000
11111121111111111111111000000000000000000001100000000000000000
10000000000000000000000000000000000000000000000000000000000001
10000002012111110000000000020121111100000000000201211111000001
10010000000000010000000100000000000100000001000000000001000001
10010020000220111000100100200002201110001001002000022011100011
10101000111100000000001010001111000000000010100011110000000001
10000000000000000000000000000000000000000000000000000000000001
10000000000000000000000000000000000000000000000000000000000001
10000002012111110000000000020121111100000000000201211111000001
10010000000000010000000100000000000100000001000000000001000001
10010020000220111000100100200002201110001001002000022011100011
10101000111100000000001010001111000000000010100011110000000001
10000000000000000000011000000000000000000001100000000000000000