11111111111111111111111000000000000000000001100000000000000000
10000000000000000000000000000000000000000000000000000000000001
10000001011111110000000000010111111100000000000101111111000001
10010000000000010000000100000000000100000001000000000001000001
10010010000110111000100100100001101110001001001000011011100011
10101000111100000000001010001111000000000010100011110000000001
10000000000000000000000000000000000000000000000000000000000001
10000000000000000000000000000000000000000000000000000000000001
10000001011111110000000000010111111100000000000101111111000001
10010000000000010000000100000000000100000001000000000001000001
10010010000110111000100100100001101110001001001000011011100011
10101000111100000000001010001111000000000010100011110000000001
10000000000000000000011000000000000000000001100000000000000000
11111111111111111111111000000000000000000001100000000000000000
10000000000000000000000000000000000000000000000000000000000001
10000001011111110000000000010111111100000000000101111111000001
10010000000000010000000100000000000100000001000000000001000001
10010010000110111000100100100001101110001001001000011011100011
10101000111100000000001010001111000000000010100011110000000001
10000000000000000000000000000000000000000000000000000000000001
10000000000000000000000000000000000000000000000000000000000001
10000001011111110000000000010111111100000000000101111111000001
10010000000000010000000100000000000100000001000000000001000001
10010010000110111000100100100001101110001001001000011011100011
10101000111100000000001010001111000000000010100011110000000001
10000000000000000000011000000000000000000001100000000000000000
11111111111111111111111000000000000000000001100000000000000000
10000000000000000000000000000000000000000000000000000000000001
10000001011111110000000000010111111100000000000101111111000001
10010000000000010000000100000000000100000001000000000001000001
10010010000110111000100100100001101110001001001000011011100011
10101000111100000000001010001111000000000010100011110000000001
10000000000000000000000000000000000000000000000000000000000001
10000000000000000000000000000000000000000000000000000000000001
10000001011111110000000000010111111100000000000101111111000001
10010000000000010000000100000000000100000001000000000001000001
10010010000110111000100100100001101110001001001000011011100011
10101000111100000000001010001111000000000010100011110000000001
10000000000000000000011000000000000000000001100000000000000000